######################
#....................#
#..#.................#
#....................#
#....................#
#.......P............#
#....................#
#....................#
#.........K..........#
#....................#
#....................#
######################
